1111111.....z
1......1.....
1.....1......
111111.......
1.....1......
1......1.....
1......1.....
1111111p.....